-21
21
8
-8
0000000000000000000000000000000000000000000
0000000000000000000000000000000000000000000
0000000000000000000000000000000000000000000
0000000000000000000000000011111110000000000
0000000100000000000000000011111110000000000
0000000000000000000000000011111110000010000
0000000000000000000000000011111110000000000
0000000000000000000000000011111110000000000
0000000000000000000000000011111110000000000
0000000000001000000000000011111110000000000
0000000000000000000000000000000000000000000
0000100000000000000000000000000000001000000
0000000000000000000000000000000000000000000
0000000000000000010000000000000000000000000
0000000000000000000000000000000000000000000
0000000000000000000000000000000000000000000
0000000000000000000000000000000000000000000
