-17
18
6
-5
000000000000000000000000000000000000
000000000000000000000011111110000000
000100000000000000000011111110000000
000000000000000000000011111110000010
000000000000000000000011111110000000
000000000000000000000011111110000000
000000000000000000000011111110000000
000000001000000000000011111110000000
000000000000000000000000000000000000
100000000000000000000000000000001000
000000000000000000000000000000000000
000000000000010000000000000000000000
